200000000000000000000000000000
100000000000000000000000000000
100000000000000000000000000000
100000000000000000000000000000
100000000000000000000000000000
122222220000000000000000000000
111111110000000000000000000000
111111110000000000000000000000
111111112222222222222222222222
111111111111111111111111111111
111111111111111111100000110000
111111111111111111100000100000
111111111111111111100000100000
111111111111111111100000000000
