000000022222000000000000000000000000000022222000000000000000000000000000022222000000000000000000000000000022222000000000000000020000
000000000000000000000000000000000000000000000000000000000000000000000000000000000000000000000000000000000000000000000000000000010000
222000000000000022200000022200000222000000000000022200000022200000222000000000000022200000022200000222000000000000022200000022210000
111222222222222211100002211100000111222222222222211100002211100000111222222222222211100002211100000111222222222222211100002211110000
111111111111111111100001111100000111111111111111111100001111100000111111111111111111100001111100000111111111111111111100001111100000
111111111111111111100000110000000111111111111111111100000110000000111111111111111111100000110000000111111111111111111100000110000000
111111111111111111100000100000000111111111111111111100000100000000111111111111111111100000100000000111111111111111111100000100000000
111111111111111111100000100000000111111111111111111100000100000000111111111111111111100000100000000111111111111111111100000100000000
111111111111111111100000000000000111111111111111111100000000000000111111111111111111100000000000000111111111111111111100000000000000
