000000000000000000000000000000000000000000000000000000000000000000000000000000000000000000000000000000000000000000000000000000000000000000000000000000000000000000000000000000000000000000000000000000000000000000000000000000000000000000000000000000000000000000000000000000000000000000000000000000000000
000000000000000000000000000000000000000000000000000000000000000000000000000000000000000000000000000000000000000000000000000000000000000000000000000000000000000000000000000000000000000000000000000000000000000000000000000000000000000000000000000000000000000000000000000000000000000000000000000000000000
000000000000000000000000000000000000000000000000000000000000000000000000000000000000000000000000000000000000000000000000000000000000000000000000000000000000000000000000000000000000000000000000000000000000000000000000000000000000000000000000000000000000000000000000000000000000000000000000000000000000
222222222222222222222222222222222222222222222222222222222222222222222222222222222222222222222222222222222222222222222222222222222222222222222222222222222222222222222222222222222222222222222222222222222222222222222222222222222222222222222222222222222222222222222222222222222222222222222222222222222222
111111111111111111111111111111111111111111111111111111111111111111111111111111111111111111111111111111111111111111111111111111111111111111111111111111111111111111111111111111111111111111111111111111111111111111111111111111111111111111111111111111111111111111111111111111111111111111111111111111111111
111111111111111111100000110000111111111111111111100000110000111111111111111111100000110000111111111111111111100000110000111111111111111111100000110000111111111111111111100000110000111111111111111111100000110000111111111111111111100000110000111111111111111111100000110000111111111111111111100000110000
111111111111111111100000100000111111111111111111100000100000111111111111111111100000100000111111111111111111100000100000111111111111111111100000100000111111111111111111100000100000111111111111111111100000100000111111111111111111100000100000111111111111111111100000100000111111111111111111100000100000
111111111111111111100000100000111111111111111111100000100000111111111111111111100000100000111111111111111111100000100000111111111111111111100000100000111111111111111111100000100000111111111111111111100000100000111111111111111111100000100000111111111111111111100000100000111111111111111111100000100000
111111111111111111100000000000111111111111111111100000000000111111111111111111100000000000111111111111111111100000000000111111111111111111100000000000111111111111111111100000000000111111111111111111100000000000111111111111111111100000000000111111111111111111100000000000111111111111111111100000000000
